___***_***___
_-*-*-*-*-*-_
__*__*_*__*__
*-*-*-*-*-*-*
*-*-*-*-*-*-*
******_******
*****_-_*****
******_******
*-*-*-*-*-*-*
*************
*-*-*-*-*-*-*
__*__*_*__*__
_-*-*-*-*-*-_
___***_***___
