__***********__
____---_---____
*_*_*_*_*_*_*_*
*_____________*
*-*_*_*_*_*_*-*
*-*_*_*_*_*_*-*
*-___________-*
*_____________*
*-___________-*
*-*_*_*_*_*_*-*
*-___________-*
*_*_*_*_*_*_*_*
*_____________*
*_*_*_*_*_*_*_*
____---_---____
__***********__
